1111111
1P00001
100C001
100E001
1C00001
1111111