1111111
1P00001
100C0C1
1000101
1C001CE
1111111