1111111
1P00001
100C001
10000E1
1C001C1
1111111