1111111
1P00001
100C1
10001
1C00E01
1111111