1111111
1P00001
100C001
1001111
1C01E01
1111111