1111111111111111111111111111111111111111
100000000000C000000000000000000000000001
100000000000C000000000000000000000000001
1000P0000000C000000000000000000000000001
100000000000C000000000000000000000000001
100000000000C000000000000000000000000001
100000000000E000000000000000000000000001
100000000000C000000000000000000000000001
100000000000C000000000000000000000000001
1000000000000000000000000000000000000001
100000000000C000000000000000000000000001
1000000000000000000000000000000000000001
100000000000C000000000000000000000000001
100000000000C000000000000000000000000001
1111111111111111111111111111111111111111