1111111111111111111111111111111111111111111111111
100000000000C000000000000000000000000000000000001
1000000000000000000000000000000000C00000000000001
100000C00000C000000000000000000000000000000000001
1000000000000000000000000000000000000000000000001
1000000000000000000000000000000000C00000000000001
100000000P000000000000000000000000000000000000001
10000000C0000000000000000000000000000000000000001
1000000000000000000000000000000000000000000000001
100000000000000000000000000000000E000000000000001
10000000C00000000000000C0000000000000000000000001
10000000C0000000000000000000000000000000000000001
10000000000000000000000CC000000000C00000000000001
1000000000000000000000000000000000000000000000001
1000000000000000000000000000000000000000000000001
1000000000000000000000000000000000000000000000001
1000000000000000000000000000000000000000000000001
1000000000000000000000000000000000000000000000001
1000000000000000000000000000000000000000000000001
1000000000000000000000000000000000000000000000001
1000000000000000000000000000000000000000000000001
1000000000000000000000000000000000000000000000001
1000000000000000000000000000000000000000000000001
1000000000000000000000000000000000000000000000001
1000000000000000000000000000000000000000000000001
1000000000000000000000000000000000000000000000001
1000000000000000000000000000000000000000000000001
1000000000000000000000000000000000000000000000001
1000000000000000000000000000000000000000000000001
1000000000000000000000000000000000000000000000001
1111111111111111111111111111111111111111111111111
