1111111
1P00B01
100C001
100E001
1C00001
1111111