1111111
1PB0B01
1B0C001
100E001
1C00001
1111111